"W", "W", "W", "W"
"W", "t", "t", "W"
"W", "t", "T", "W"
"W", "t", "P", "W"
"W", " ", " ", "W"
"W", "t", " ", "W"
"W", "t", "t", "W"
"W", "W", "W", "W"
1000
