#,B,B,B,B,B,B,B,B,B,B,B,B,B,#
#,B,T, , , ,B,B, ,B, , , , ,#
#, ,M,M, ,B, ,B, , , , , , ,#
#, , , , , , , , ,B,B,B, , ,#
#,M,M,M,M,M, ,B,B, ,B, , ,B,#
#,B, , , , , , , , , , , ,B,#
#,B, , ,M, ,t,t,t,t, ,B, ,B,#
#, , ,M, , , , , , ,t,B, ,B,#
#, , ,P,M,t,t, , , , ,B, ,B,#
#, ,t,M, , , ,t,t,t, , , , ,#
#, ,t, , , , ,t, ,t,t, , , ,#
#, , , ,t,t, , , , ,t,t, ,t,#
#, ,t, , ,t, , ,t, , , , ,t,#
#, , ,t,t,t,t, , , , ,t, , ,#
#,#,#,#,#,#,#,#,#,#,#,#,#,#,#
1000,,,,,,,,,,,,,
