#,#,#,#,#,#,#,#,#,#,#,#
#, , , ,w,T,m, , , , ,#
#, ,w,T,T,T,w, ,w,w, ,#
#, ,w,w,w,w,w, , ,w, ,#
#, , , , , ,w,w, ,w, ,#
#,w,w,w,w, ,w, , ,w, ,#
#,w, , , , ,w, ,w,w, ,#
#,w, ,w,w,w,w, , ,w, ,#
#,w, , , , ,w,w, ,w, ,#
#,w,w,w,w, , , , ,w,P,#
#,#,#,#,#,#,#,#,#,#,#,#
1000,,,,,,,,,,
