#,#,#,#,#,#,#,#,#,#,#,#
#,w,w,w,w,m,m,m, , ,P,#
#,w,w,w,w,m,m,m, ,m,m,#
#,w,w,w,w,m,m,m, ,m,m,#
#,w,w,w,w,m,m,m, ,m,m,#
#,w,w,w,w,m,m,m, ,m,m,#
#,w,w,w,m,m,m,m, ,m,m,#
#,w,w,w,m, , , , ,m,m,#
#,m,m,m,m, ,m,m,m,m,m,#
#,T, , , , ,m,m,m,m,m,#
#,#,#,#,#,#,#,#,#,#,#,#
1000,,,,,,,,,,
