#,#,#,#,#,#,#,#,#,#,#,#
#, , , , , , , , , , ,#
#, , , , ,P, ,M, , , ,#
#, ,M,M,t,t,t,M, , , ,#
#, ,M,M,M,M,t,M, , , ,#
#, ,B,T,T,T,T, , , , ,#
#, ,B,T,T,T,T,M, , , ,#
#, ,B,T,T,T,T,M, , , ,#
#, ,B,T,T,T,T,M, , , ,#
#, ,B,T,T,T,T,M, , , ,#
#,#,#,#,#,#,#,#,#,#,#,#
1000,,,,,,,,,,
