#,#,#,#,#,#,#,#,#,#,#,#
#,T, , , , , , , , ,T,#
#,M,L, , , , , ,w,w, ,#
#,L,L, , , , ,w,w,w, ,#
#, , , , , , ,w,w,w, ,#
#,T,t, , , ,w,w,w,w,T,#
#,M,L, , ,w,w,L,L,w, ,#
#,L,L, , , ,L,L,L, , ,#
#, , , , , ,L, , , ,M,#
#,P, , , , ,M, , , ,T,#
#,#,#,#,#,#,#,#,#,#,#,#
1000,,,,,,,,,,
