#,#,#,#,#,#,#,#,#,#,#,#,#,#,#,#,#,#,#,#,#,#,#,#,#,#,#,#,#,#,#,#,#,#,#,#,#,#,#,#,#,#,#,#,#,#,#,#,#,#
#,#,T,T,T, , , , , , ,#, ,#,#, , , , ,#, , , ,#, , , , ,#, , , ,#, , ,#, ,#, ,#, , , ,#, ,#,T, , ,#
#,T,#,T,#, ,#, ,#,#, ,#, , , ,#, ,#,#, , ,#,#,#,#,#, ,#,T,#, ,#, , ,#, , , , , ,#, ,#, , , ,#, ,#,#
#,T,T,#,T,T,T,#, , , , , ,#,#, , ,#,#,#, , , ,#, , , ,#, , , ,#, ,#,#,#, ,#,T,#, , ,#,#, ,#, , , ,#
#,#,T,#,T,#,#, ,#, ,#,#, , , , ,#, ,#, , ,#, ,#, ,#, ,#, ,#, , , , ,#,#, , ,#, ,#, , ,#, , , ,#, ,#
#,T,T, ,#, , , ,#,#,#,#, ,#,#, , , , ,#, ,#,T,#, ,#, , ,#, ,#,#, ,#, , ,#, ,#, , ,#, , , ,#, , ,#,#
#,T,#, , ,#,#, , , ,#, ,#, ,#,#, ,#,#, , , ,#,#,#, , ,#, , ,#, , , , ,#, , , ,#, , , ,#,#, ,#,#, ,#
#,T,#, ,#, , ,#, ,#,#, , , , , , , ,#,#, ,#, ,#, , ,#,#,#, , , ,#, ,#,#,#, ,#, ,#,#, ,#,#, , , , ,#
#,#, , , ,#, ,#, ,#, ,#, ,#, ,#, ,#, , , ,#, , ,#, , ,#, ,#, ,#,#, , ,#, , ,#, , ,#, , , , ,#, ,#,#
#, ,#, ,#, , , , ,#, , ,#, ,#,#, , ,#, ,#,#, ,#, , ,#, , ,#, ,#, ,#, , ,#, , ,#, , , ,#, ,#,#,#, ,#
#, ,#, , ,#, ,#, , ,#, , , ,#, , ,#,#, ,#, , ,#,#, , , ,#,#,#, , , ,#, ,#, ,#, , ,#, , ,#,#, ,#, ,#
#, , , ,#,T,T,T,#, ,#,#,#, , , ,#, , , ,#, ,#, , , ,#,#, ,#,#,#, ,#, , ,#, , , ,#, ,#,#, , , , , ,#
#, ,#, , ,#,T,#, , , , ,#,#,#, , ,#,#, , , , ,#, ,#, , , , ,#, , , ,#, , , ,#,#, , , , , ,#, ,#, ,#
#, ,#, ,#, ,#, , ,#, ,#, , ,#, ,#, , ,#,#, ,#, , ,#, ,#, ,#, ,#,#, ,#, ,#, , ,#, ,#,#, ,#, ,#, ,#,#
#, , ,#, , ,#,#, , ,#,#, ,#, , , , ,#, , , , ,#, , , ,#, ,#, , ,#, , ,#, ,#, , , , , ,#,#, , , , ,#
#,#, , ,#, , , , ,#,#, , , , ,#, ,#,#,#,#, ,#,#,#, ,#, ,#, ,#, , ,#, , , , , ,#,#, ,#, , , ,#,#, ,#
#, ,#, ,#, ,#, ,#,#, ,#,#, ,#, , , ,#, ,#, ,#,#, , ,#, , , ,#, ,#, ,#,#, ,#, ,#, , , ,#,#, , , ,#,#
#, ,#, , ,#, , ,#, , ,#, , , ,#, ,#,#, , , , , , ,#, , ,#, ,#, ,#, ,#, , ,#,#, ,#, ,#, ,#, ,#, , ,#
#, , , ,#, ,#, ,#,#, , ,#, ,#, , , , ,#,#, ,#, ,#, , ,#,#,#, , , , , ,#, , ,#, , ,#, , , , ,#, ,#,#
#, ,#, , , , , , , , ,#, ,#, ,#, ,#,#, , ,#,#, , ,#, , ,#, ,#, ,#,#, , , ,#,#, ,#, ,#, ,#,#, ,#,#,#
#,#, ,#,#,#,#,#, ,#,#, , , , , , , , ,#, , , , ,#, , ,#, , , ,#, , ,#,#, ,#, , , , , , , , , , ,#,#
#, , , , , , , , , ,#,#, ,#,#, ,#, ,#,#, ,#,#, ,#,#, , ,#, ,#, ,#, , ,#, , ,#, ,#,#, ,#,#, ,#, , ,#
#, ,#,#, ,#, ,#,#, , , ,#, ,#, , ,#,#, ,#, , , , ,#, ,#, , , , ,#, ,#, ,#, ,#, , , ,#, ,#, , ,#, ,#
#,#, , , ,#,#,#, ,#, ,#,#, ,#, ,#, , , , ,#,#, ,#, , ,#, ,#,#,#, , ,#, ,#, , , ,#,#, , , ,#, ,#, ,#
#, , ,#,#, , , , , , , , , , , , ,#,#,#, ,#, , ,#, ,#, , ,#, , , ,#, , , ,#, ,#, ,#, ,#,#, ,#, ,#,#
#,#,#, , ,#, ,#,#, ,#, ,#,#, ,#, , , ,#, ,#,#, , , , , ,#, ,#, ,#, , ,#, ,#, , , , , , ,#, ,#, , ,#
#, ,#, ,#, ,#, , , , ,#, , ,#, ,#, ,#, , , , ,#,#, ,#, ,#, , , , ,#,#, , ,#, ,#, ,#,#, , , , , ,#,#
#, , , , , , , ,#, ,#, ,#, , , , , , ,#, ,#,#, , ,#, , , , ,#, ,#, , , ,#, , ,#, , ,#, ,#,#, ,#, ,#
#, ,#,#,#, ,#, , ,#, , , ,#, ,#, ,#, , , , , , ,#, ,#, ,#,#, ,#, ,#,#, ,#, ,#, ,#, , ,#, , ,#,#, ,#
#,#, , , ,#, , ,#,#,#, ,#, ,#, ,#,#,#, ,#, ,#, ,#, ,#, , , , , , , , , , , , , ,#, ,#, ,#, , , , ,#
#,#,#,#, , ,#,#, ,#, , , , , , ,#,#, , ,#, ,#, ,#, , , ,#,#, ,#,#,#, ,#, ,#,#,#, ,#, , , , ,#,#, ,#
#,#, , , ,#, ,#, , ,#, ,#, ,#, , , ,#, , ,#, , , ,#, ,#,#, , ,#, , ,#,#,#,#, ,#, , , ,#, ,#, , ,#,#
#, ,#,#, , , , , ,#, ,#,#,#,#,#,#, ,#, ,#, , ,#,#, , ,#, ,#,#, , ,#, ,#, , , ,#,#, ,#, , ,#, ,#, ,#
#, , , ,#,#, ,#,#,#, , ,#, ,#, , , , ,#, ,#, , , ,#, ,#, , ,#, ,#, , , ,#, ,#, , , ,#, ,#, , , , ,#
#, ,#, , , , , , , , ,#,#, , ,#,#,#, , , , , ,#, , , , , ,#, , , ,#,#, ,#, ,#, ,#,#, ,#, , ,#,#,#,#
#,#, , ,#, ,#,#,#,#, , , ,#, ,#, ,#,#,#,#, ,#, ,#, ,#,#,#, , ,#, ,#, , , , , , , , , , ,#, , , , ,#
#, , ,#, ,#, ,#, , , ,#,#, , ,#, , , , ,#,#,#, , , , , ,#, ,#, ,#, , ,#, ,#, ,#,#, ,#, , , ,#,#, ,#
#, ,#, , , , ,#, ,#, , , ,#, , ,#, ,#, , , , ,#, ,#,#,P, , ,#, , , ,#,#,#, , , ,#, ,#,#, ,#, , , ,#
#,T,#, ,#,#, ,#,#, , ,#, , ,#, , ,#, ,#,#, ,#, ,#, , , ,#, , , ,#,#,#,#,#,#,#, ,#, , , ,#, ,#,#, ,#
#,#, ,#, ,#, , , ,#,#,#,#, , , ,#, , , , , ,#, , , ,#, , ,#, ,#,#, ,#,#,#, , ,#,#, ,#,#, , , ,#, ,#
#, , , , , ,#,#, , , ,#, , ,#, , , ,#, ,#, , , ,#,#, , ,#, , , , , , ,#, ,#, , , ,#, , ,#, ,#, ,#,#
#,#, ,#,#, , ,#, ,#, ,#, ,#, ,#, ,#, ,#, , ,#, , ,#,#, , ,#,#, ,#, ,#,#, ,#, ,#,#, , ,#, , , , , ,#
#, ,#, , , ,#, ,#,#, ,#,#, , , ,#, , , , ,#, , ,#, , , ,#, ,#,#, ,#, , , , , , , ,#, ,#,#, ,#, ,#,#
#, , , ,#, , , , , , , , ,#,#, , ,#, ,#, , ,#, ,#,#,#, , , , , , , ,#,#, ,#,#, ,#, , , , , ,#,#,#,#
#, ,#,#,#,#, ,#,#, ,#,#, ,#, ,#, , , , ,#, , ,#, , , , ,#, ,#,#, ,#, ,#, ,#, ,#, , ,#,#, ,#, , ,#,#
#, ,#, ,#, , , , ,#, , , , , , , ,#, ,#, ,#,#, , ,#, ,#, , , ,#, , , ,#, ,#, ,#, ,#,#, ,#, , ,#, ,#
#,#, , ,#, ,#, ,#, , ,#, ,#, ,#, , ,#, , ,#, ,#,#, , , ,#, ,#, ,#,#,#, , , , , , , ,#, ,#, ,#, , ,#
#,#,#, , ,#, ,#, ,#,#, , , ,#, , ,#, ,#, , , , , , ,#,#, , , , ,#, ,#,#, ,#, ,#,#, , , , , , , ,#,#
#,#,#,#, , , , , , , , ,#, , ,#, , , , ,#, ,#, ,#, , , ,#, ,#, , , , , , , ,#, , , ,#, ,#, ,#, , ,#
#,#,#,#,#,#,#,#,#,#,#,#,#,#,#,#,#,#,#,#,#,#,#,#,#,#,#,#,#,#,#,#,#,#,#,#,#,#,#,#,#,#,#,#,#,#,#,#,#,#
3000,,,,,,,,,,,,,,,,,,,,,,,,,,,,,,,,,,,,,,,,,,,,,,,,
