#,#,#,#,#,#,#,#,#,#,#,#,#,#,#,#,#,#,#,#,#,#,#,#,#,#,#,#,#,#,#,#,#,#,#,#,#,#,#,#,#,#,#,#,#,#,#,#,#,#
#, , , ,#, ,#,#,#, ,#, ,#, , , , , ,#, , ,#, ,#, ,#, , , ,#, , , , , ,#, , , , , , ,#,#,#, , ,#, ,#
#, ,#,#, , , ,#, , , , ,#, ,#,#, ,#, , ,#, , , , , ,#, ,#, ,#,#,#, ,#,#, ,#, ,#,#,#, ,#, , ,#, , ,#
#, , , , ,#, , ,#, ,#, , ,#, , , , ,#, , ,#, ,#,#, , , , , , , ,#, ,#, , ,#, ,#, , , , ,#, ,#, ,#,#
#, ,#, ,#,#,#, ,#,#, , ,#, , ,#,#, , ,#, , ,#, , ,#, ,#,#, ,#,#, , , , ,#, ,#, , ,#,#, , , , , ,#,#
#,#, ,#, ,#, , , , ,#, , ,#, , ,#, ,#,#,#, , , ,#, , , ,#, ,#, , ,#, ,#, , ,#,#, , , ,#,#,#, ,#, ,#
#,#, , , , , ,#,#, , , ,#, ,#,#, , , ,#, ,#, ,#, , ,#, , ,#, ,#, ,#, , , ,#, ,#, ,#,#,#, , ,#, , ,#
#, , ,#,#,#,#, , , ,#, ,#, ,#, ,#, ,#,#, ,#, ,#, ,#, ,#, , , ,#, , ,#, ,#, , , , , , , , ,#, , ,#,#
#, ,#, , , , , ,#,#,#, , , , , , , , , , , , , ,#, , ,#, ,#, , , ,#, ,#,#, ,#,#, ,#, ,#,#, ,#, ,#,#
#,#, , ,#,#, ,#, , ,#,#, ,#,#, ,#,#, ,#, ,#,#, ,#,#, , , , ,#, ,#,#, , , ,#, ,#, , ,#, ,#, , , , ,#
#, ,#,#, , ,#,#,#, , , , , , ,#, , ,#, ,#, ,#, , , ,#, ,#, , ,#, , ,#, ,#,#, , , ,#, , ,#, ,#,#, ,#
#, ,#,#, ,#, ,#, ,#,#,#, ,#,#, , ,#,#, , , , , ,#, , , ,#, ,#, ,#, ,#, , , , ,#, , , ,#, , , , ,#,#
#, , , , , , ,#, , , , ,#,#, ,#, ,#, , ,#,#, ,#, ,#,#, ,#, , , , , , , ,#,#,#, , ,#, , , ,#, ,#, ,#
#,#, ,#,#,#, , ,#, ,#, , , , , , , ,#,#, , ,#, , ,#, , , ,#,#, ,#, ,#,#,#, , ,#, ,#,#, ,#, ,#, , ,#
#,#,#,#, , , ,#,#,#, ,#,#, ,#,#, ,#,#,#,#, , ,#, ,#,#,P,#, ,#,#,#, , , , , ,#, , , ,#, , , , , ,#,#
#,#, , , ,#, , ,#,#, ,#, , ,#, , ,#,#,#, ,#, ,#, , , , , , , , , ,#, ,#,#, , ,#,#, , ,#,#,#,#, , ,#
#, , ,#, , ,#, , , , , ,#,#, ,#, , ,#, , , , , , ,#, ,#, ,#, ,#,#,#,#, , ,#, , , ,#,#,#, , ,#, ,#,#
#,#, ,#, ,#,#,#,#, ,#, , , , , ,#, , , ,#,#, ,#, , ,#, , ,#, ,#, ,#, ,#, , , ,#, , , , , ,#, ,#, ,#
#, ,#,#,#, ,#, , ,#, ,#, ,#,#, , ,#, ,#,#,#, , ,#, ,#, ,#, , , , , , , ,#, ,#, , ,#,#, ,#,#, , , ,#
#, , ,#, , , ,#, , , , ,#, , ,#, , , , ,#, , ,#,#, , ,#,#, ,#, ,#,#,#, , ,#,#,#, , , ,#, , , ,#, ,#
#,#, , ,#, ,#, ,#,#,#, , ,#, , , ,#, ,#, ,#, , , ,#,#, , , , ,#, ,#, ,#, , ,#, ,#,#,#, ,#, ,#, ,#,#
#, , ,#, , , , , , ,#, ,#, , ,#, , ,#,#, , , ,#,#,#, ,#, ,#, ,#, , , , ,#, , , , , , , , , , , , ,#
#,#, , , ,#,#, ,#, , , , , ,#, , ,#, , , ,#, , ,#, , , , ,#, , , ,#,#, , ,#,#, ,#,#, ,#,#,#, ,#, ,#
#, , ,#, ,#, ,#,#,#,#, ,#, ,#,#, , ,#, ,#, , ,#, , ,#,#, , ,#,#, ,#, , ,#, , , , ,#, , , , ,#, ,#,#
#,#,#, ,#, , , ,#, , , ,#, , ,#, ,#,#, , ,#, , ,#, ,#, ,#, , ,#, ,#, ,#, , ,#, ,#, , ,#,#, , , , ,#
#, , , , , ,#, , , ,#, ,#, ,#, , , , ,#, , ,#, ,#, , , ,#, ,#, , , ,#, ,#,#, , , ,#, , , ,#,#, ,#,#
#,#, ,#, ,#, , ,#, ,#, , ,#, ,#,#, ,#,#,#, ,#, , ,#, ,#, , , ,#,#, , , ,#, , ,#, , ,#, ,#, , , , ,#
#, ,#, ,#, , ,#, , , ,#,#, , , , , , ,#, , , ,#, , ,#,#,#, ,#, , ,#, ,#,#, ,#, , ,#, , , ,#, ,#, ,#
#, , , , , ,#,#, ,#, , ,#, ,#, ,#, ,#, ,#,#,#, , ,#, ,#, , ,#, ,#, ,#, , , ,#, ,#,#,#, ,#, , , ,#,#
#,#, ,#, ,#, , , ,#, ,#, ,#, , ,#, , , , , , ,#, , , , ,#, , , , , ,#,#, ,#,#,#, ,#,#, , ,#,#, ,#,#
#, ,#,#, ,#, ,#, , ,#, , , ,#, ,#, ,#, ,#, ,#,#,#, ,#,#,#,#, ,#, ,#, ,#, ,#,#, , , , ,#, ,#, , , ,#
#, , , , , ,#, , ,#,#, ,#, , , , ,#, ,#, , , ,#, , , , ,#,#, , ,#,#, , , , , , ,#,#,#, , ,#, ,#, ,#
#,#, ,#, ,#, , ,#, , ,#, , ,#, ,#, , ,#,#, ,#, , ,#,#, , , ,#, , , ,#, ,#, ,#, , , , ,#,#,#,#, , ,#
#, ,#, , ,#, ,#,#,#, , ,#,#, , , , ,#, ,#, , ,#, , ,#, ,#,#, , ,#, , ,#, , , ,#, ,#, , , ,#,#,#, ,#
#, , ,#, ,#, ,#,#, ,#, , , , ,#, ,#,#, , , ,#, , ,#, , , , ,#, ,#, ,#, , ,#, , ,#,#, ,#, , ,#, , ,#
#,#, ,#, ,#,#, , , , , ,#,#, ,#, , , ,#, ,#, , ,#, , ,#, ,#, ,#, , ,#, ,#, , ,#, , , , ,#, , ,#, ,#
#, , , , , , ,#,#,#, ,#, , , ,#, ,#,#, ,#, ,#, ,#, ,#, , , , ,#, ,#, ,#,#,#, ,#, ,#,#, , ,#,#, , ,#
#, ,#, ,#, ,#,#, , , , ,#,#, ,#, , , , , , , ,#, , ,#, ,#, ,#, , , , , ,#, , , ,#, , , ,#,#, ,#, ,#
#, , ,#, ,#, , , ,#, ,#, , , ,#, ,#,#,#,#, ,#, ,#, , ,#, , ,#, ,#,#, ,#, , ,#, , ,#,#, , , , ,#, ,#
#, ,#, , , ,#, ,#,#,#, , ,#, ,#, , , , , ,#, , , , ,#, ,#, , ,#, ,#, , ,#,#, ,#, , , ,#,#, ,#, , ,#
#, ,#,#,#, , , ,#,#,#,#, ,#, ,#, ,#, ,#,#, , ,#, ,#,#, ,T,#, ,#, , , ,#, , , , , ,#, ,#, , , ,#, ,#
#,#, , , , ,#, , ,#, , , ,#, , ,#, , , , ,#, ,#, ,#, , ,#, , , ,#, ,#,#, ,#, ,#, , ,#,#, ,#,#,T, ,#
#, , ,#, ,#, , ,#, , ,#,#, , ,#, ,#, ,#, , ,#, ,#, ,#, , , ,#, , ,#, , , ,#,#,#,#, , , ,#, ,T,#, ,#
#,#, , ,#, ,#, ,#,#, , ,#,#, ,#, , ,#,#,#, , , ,#, , ,#, ,#, ,#, ,#,#,#, , , ,#,#, ,#,#,#, ,#,#,T,#
#, ,#,#, , ,#, , , ,#,#, , , , ,#, ,#,#, , ,#, , , ,#, ,#, , , , , , , ,#, ,#, , , , , , , , , ,#,#
#, , , , ,#, , ,#, ,#, ,#, ,#, , , , , ,#, ,#, ,#, , , ,#, ,#, ,#, ,#,#,T, ,T,#, ,#, ,#, ,#,#, , ,#
#,#, ,#, , , ,#, ,#, , , , ,#, ,#, ,#,#, , , ,#,#,#, ,#,#, ,#, , ,#,T,T,#,T,#,#,T,#, , ,#,T,T, ,#,#
#, ,#, , ,#, ,#, ,#,#, ,#,#, , ,#, ,#, , ,#,#, ,#, , , , ,#,T,#, , ,#,T,T,T,#,T,#, , ,#,T,T,#,T,#,#
#, , , ,#, , , , , , ,#,#,#,#, , ,#,#,#, , , , , ,#,#, ,#,T,T,T, ,#,T,T,#,#,T,T, , ,#,#,#,T,#,T,T,#
#,#,#,#,#,#,#,#,#,#,#,#,#,#,#,#,#,#,#,#,#,#,#,#,#,#,#,#,#,#,#,#,#,#,#,#,#,#,#,#,#,#,#,#,#,#,#,#,#,#
3074,,,,,,,,,,,,,,,,,,,,,,,,,,,,,,,,,,,,,,,,,,,,,,,,
